Puzzle
Puzzle_Level_1
0
30
true
100111
111111
111111
111111
111111
111001
3
